.........
#.......#
#.......#
#.......#
#.......#
#.......#
#.......#
#...@...#
#########