.........
.........
.........
.........
.........
.........
.........
....@....
#########